mmmmmmmmmmmmmmmmmmmm
md00000000000000000m
m000000000000000000m
m000000000000000000m
m000000000000000000m
m000000000000000000m
m000000000000000000m
m000000000000000000m
m000000000000000000m
m000000000000000000m
m000000000000000000m
m000000000000000000m
m000000000000000000m
m000000000000000000m
m000000000000000000m
m000000000000000000m
m000000000000000000m
m000000000000000000m
m00000000000000000am
mmmmmmmmmmmmmmmmmmmm
cccccccccccccccccccc