mmmmmmmmmmmmmmmmmmmm
md000000000000000m0m
m00mmmmmmmmmmmmmm00m
m0m00m00000000m00m0m
m00m00m000000m00m00m
m000m00m0000m00m000m
m00m000m0000m000m00m
m0m0000m0000m0000m0m
m00m000000000m00m00m
m000m00m0000m00m000m
m00m000m0000m000m00m
m000000m0000m000000m
m00m00m000000m00m00m
m000m00m0000m00m000m
m00m000m0000m000m00m
m000000m0000m0000m0m
m00m00m000000000m00m
m000m00m0000m00m000m
m00m000m0000m000ma0m
mmmmmmmmmmmmmmmmmmmm
cccccccccccccccccccc