mmmmmmmmmmmmmmmmmmmm
md00000000000m00000m
m00m00m00m00m00m00mm
mm00m00m00m00m00m00m
m00m00m00m00m00m00mm
mm00m00m00m00m00m00m
m00m00m00m00m00m00mm
mm00000000000000000m
m00m00m00m00m00m00mm
mm00m00m00m00m00m00m
m00m00m00m00m00m00mm
mm00m00m00m00m00m00m
m0mm00m00m00m00m00mm
mm00000000000000000m
m00m00m00m00m00m00mm
mm00m00m00m00m00m00m
m00m00m00m00m00m00mm
mm00m00m00m00m00m00m
m00000m00000m00000am
mmmmmmmmmmmmmmmmmmmm
cccccccccccccccccccc